11111
1PEC1
10001
10000
10001
11110